BiakaPygmy	Africa
Brahui	SouthAsia
Druze	NearEast
French	Europe
Han	EastAsia
Hazara	SouthAsia
Italian	Europe
Japanese	EastAsia
Kalash	SouthAsia
Karitiana	Americas
Melanesian	Oceania
Orcadian	Europe
Palestinian	NearEast
Pathan	SouthAsia
Pima	Americas
Russian	Europe
Sardinian	Europe
Sindhi	SouthAsia
Yakut	Siberia
Yoruba	Africa
